0000000000000s0000000
011111111111111111010
000101000101000001010
011101010101111101110
010001010001000101000
011101011101110101010
000001010000000101010
011111111101011101110
010000000101000100010
011101111111011111010
000101000100000001010
011101110111110111010
000100010101000001000
010101010101111101110
010001010000010000010
011111111101111111010
010000010000010001010
011101110111111101010
010001000001000100010
010111011111011101110
000000000e00000000000
