0000000000000000000s000000000000000000000
01010111010111110111111101110111011111110
01010101010100010101000100010001000000010
01010101111101011101010111011101011101110
01010000010001000100010100000101000100010
01111111010111110111110101110101110111110
00010100010101010100000001000100010001000
01110111110101011111111111111101110111110
00010001000100010101000100000000010101000
01110111010101110101010111010111110101010
00000001010001000100010001010001000001010
01111101010111110101111101011111111111110
01000100010100000101000000010000000100010
01110111111111011111110101110111011101110
01000001000100010100010100010001010100010
01011111110101010101111111110111010101010
01000101010001010000000001000100000101000
01011101010111111111110111111111011111110
00000101000000000100000100000001010100000
01010101011111111101010111011111010111110
01010001010101000001010101000001000101010
01110111010101111101111101111101110101010
00010101000000000000010100000000000000010
01011101111101010111010101110111110111010
01010100000101010100000101000000010101000
01110111010101010111111111111111011101110
01000100010001010100010000010001000100000
01110111010111011101011101110101111101110
00000100010001010001010001000100000101010
01110111010111110101011101110111111111010
00010100010100010101010000010001000101010
01011101111101011101110111010101011101010
01010100010001000100010001000100010001000
01110101010101111111011111111101010111010
00010001000101000100000100000101000101010
e1011101111111110101111101111111110101110
01000001000100000100010000010000010000010
01010111110101110101010101111101010111010
01010100000101000001010101000001010100010
01111111110111110111110111111101111101110
00000000000000000000000000000000000000000
